*G********************
*                    *
* ********  **********
*    *   *           *
*** ** * * ***********
*      * * ** * *    S
***  *** * ** * *    *
****** *** **     *  *
*G*  *   * ********  *
*                    *
**********************